SO ./textures_xpm/naturalbricks_hd_verydark.xpm
WE ./textures_xpm/naturalbricks_hd_middle.xpm
EA ./textures_xpm/naturalbricks_hd_middle.xpm
NO ./textures_xpm/naturalbricks_hd.xpm

F 220,100,0
C 225,30,0

111111111111111111111111111111
100000010100000100001000001001
100000000000000000000000000001
100000010100000100001000001001
111111110111111100001110111111
100000000000000100001110000001
101111111111110111111110000001
101000010000010000000000111111
101000010000011111111111100001
101000010000010000111000100001
101101111101110100111000000001
100000000000000100000000100001
111110111111110111111111101111
100010111111110100000100000001
10S000000000000000000101111011
100011111111110110111101000001
111110000000000100000001000001
111111111111111111111111111111
