SO ./sources/wall.xpm
WE ./sources/Bushes.xpm
EA ./sources/redbrick.xpm
NO ./sources/wall.xpm

F 220,100,0
C 225,30,0

11111111
11101101111111111
11000100000011111
1111000011111111
1100000N001111
1111000011111
1111000011111
1111000011111
1111000011111
1111000011111
1111000011111
1111000011111
1111000011111
1111000011111
111100001
111111111