SO ./path_to_the_south_texture
WE ./path_to_the_west_texture
EA ./path_to_the_east_texture
NO ./path_to_the_east_texture

F 220,100,0
C 225,30,0

11111111111111111111111111111
11111111101100000101000000001
10000000001100000111011111111
11110111111111011100000001111
11110111111111011101010010001
110000001101N1011100000010001
10000000000000001100000010001
11000001110101011111011110011
11111111111111111111111111111