SO ./path_to_the_south_texture
WE ./path_to_the_west_texture
EA ./path_to_the_east_texture
NO ./path_to_the_east_texture

F 220,100,0
C 225,30,0

11111111111111111
111111111111
1111N111111111111
1100111111111111
11110011111111111
11100000000011111
11100001111111111
1111111111111