SO ./path_to_the_south_texture
WE ./path_to_the_west_texture
EA ./path_to_the_east_texture
NO ./path_to_the_east_texture

F 220,100,0
C 225,30,0

        1011000001110000000000001
        1001000000000000010000000111
111111111011000001110000000000001
10000000011000001110111111111111
11110111111111011100000010001
111101111111111111111111111111
110000001                   1
100000001111111111111111111111
10000000000000001101010010001
11000001110101011111011110N0111
11110111 1110101 101111010001
11111111 1111111 111111111111
11111111 1111111 111111111111
