SO ./textures_xpm/naturalbricks_hd_verydark.xpm
WE ./textures_xpm/naturalbricks_hd_middle.xpm
EA ./textures_xpm/naturalbricks_hd_middle.xpm
NO ./textures_xpm/naturalbricks_hd.xpm

F 91,78,78
C 225,30,0


11111111111111111
12222222222222221
12222222222222221
12222222222222221
10001000100010001
10000000N00000111
10101010101010101
1000000000000000111
1000111111100001011
100001 100000000111
10100111000010011
10000000000000001
11111111111111111