SO ./path_to_the_south_texture
WE ./path_to_the_west_texture
EA ./path_to_the_east_texture
NO ./path_to_the_east_texture

F 220,100,0
C 225,30,0

111111111111
11111111111111111
1111100011111111
111110N011111111
111110001111111
11111111111111
111111111