SO ./path_to_the_south_texture
WE ./path_to_the_west_texture
EA ./path_to_the_east_texture
NO ./path_to_the_east_texture

F 220,100,0
C 225,30,0

111111111111
11101101111111111
11000100000011111
1111000011111111
1100000N001111
1111000011111
1111000011111
1111111111