SO ./path_to_the_south_texture
WE ./path_to_the_west_texture
EA ./path_to_the_east_texture
NO ./path_to_the_east_texture

F 220,100,0
C 225,30,0

     11111111111111111111111111111
        1001000001110000010000000111
1111111110110000011100000000000011
100000000110000011101111111111111
1110111111111011100000010001
1111011111111111111111111111111
110000001                   1
100000001111111111111111111111
10000000000000000001         1
110000011101010111111 11111111
11110111 1110101 101111010001
11111111 1111111 111111111111
11111111 11111111 1111111111111
